111111
100001
1P0001
1C1111
111111
