1111111111111
1P0C010001001
1000010001001
1C0E111001001
1111111111111
