11111
1P011
10111
1C0E1
11111
