11111
1P011
10011
1C0E1
11111
