11111
1P011
10011
1C0E1
1
11111
11111
