1111111
1P000C1
1G011S1
1C001E1
1000001
1111111
